

NO ./map_stuff/no.xpm
SO ./map_stuff/so.xpm
WE ./map_stuff/we.xpm      
EA ./map_stuff/ea.xpm

F 128,128,128
C 0,0,75

11111111111111
10000000000001
10000000000001
10100000000001
10000000000001
10000000000001
10100000000001
10000000000001
10000000000001
10100000000001
10100000000001
10000000000001
10000000000001
10100000000001
10000000000001
10000000000001
10100000000001
10000000000011
10100000000001
10000000000001
10000000000001
10100000000001
10000000000001
10000000000001
10100000000001
10000000000011
10000000000011
10N00000000001
10000000000001
11111111111111
