

NO ./map_stuff/teapot.xpm
SO ./map_stuff/teapot.xpm
WE ./map_stuff/teapot.xpm      
EA ./map_stuff/teapot.xpm



F 220,100,0


C 225,30,0




11111111111111
10000000000001
10000000000001
10100000000001
10000000000001
10000000000001
10100000000001
10000000000001
10000000000001
10100000000001
10000000000011
10N00000000001
10000000000001
11111111111111