

NO ./map_stuff/teapot.xpm
SO ./map_stuff/teapot.xpm
WE ./map_stuff/teapot.xpm      
EA ./map_stuff/teapot.xpm



F 110,100,0


C 115,30,0


 11111111  
  1000S001
 11111111

