

NO ./map_stuff/teapot.xpm
SO ./map_stuff/teapot.xpm
WE ./map_stuff/teapot.xpm      
EA ./map_stuff/teapot.xpm



F 110,100,0


C 115,30,0



11111111111111111   11111
10000000000000011   11001
10000000000000001   10001
1000000000000000111110001
1000000000000000000000001
1100000000000000000000001
1100000000000000000000001
1000000000000000000000001
1000000000000000000000001
1000000000000001000000001
1000000010000000000000001
1000000000000000000000001
1000000000000000000000001
1100000000000000000000001
1000000000000000000000001
11111000000000000000000011111
10000000100W0000000000011
11111000000100000000000011111
1100000000000000000000001
1100000000000000010000001
1111111111111111111111111

