

NO ./map_stuff/teapot.xpm
SO ./map_stuff/teapot.xpm
WE ./map_stuff/teapot.xpm      
EA ./map_stuff/teapot.xpm



F 220,100,0


C 225,30,0




11111111
10000001
10000001
10100001
10000011
10N00001
10000001
11111111