NO ./map_stuff/teapot.xpm
SO ./map_stuff/teapot.xpm
WE ./map_stuff/teapot.xpm      
EA ./map_stuff/teapot.xpm

F 128,128,128
C 0,0,75

 111111111111111111111111111111111111111111111111111111
 110000000000000000000000000000000000000000000000000011
 110000000000000000000000000000000000000000000000000011
 110000000000000000000000000000000000000000000000000011
 110000000000000000000000000000000000000000000000000011
 110000000000000000000000000000000000000000000000000011
 110000000000000000000000000000000000000000000000000011
 110000000000000000000000000000000000000000000000000011
 110000000000000000000000000000000000000000000000000011
 110000000000000000000000000000000000000000000000000011
 110000000000000000000000000000000000000000000000000011
 11000000000000000000000000000000Z000000000000000000011
 110000000000000000000000000000000000000000000000000011
 110000000000000000000000000000000000000000000000000011
 110000000000000000000000000000000000000000000000000011
 110000000000000000000000000000000000000000000000000011
 110000000000000000000000000000000000000000000000000011
 110000000000000000000000000000000000000000000000000011
 111111111111111111111111111111111111111111111111111111